########
###   ##
#o1x  ##
### xo##
#o##x ##
# # o ##
#x @xxo#
#   o  #
########