##########
#        #
#   1 x o#
#        #
#   ######
#        #
#   ######
#      xo#
#        #
##########
